1,1,1,0,0,0,0,1,1,0,0,0,b,1,1,1
1,1,1,0,0,0,0,0,0,0,0,0,0,1,1,1
0,0,1,1,1,A,0,1,1,0,0,1,1,1,0,0
0,0,0,0,1,0,0,1,1,0,1,1,0,0,0,0
0,0,0,0,1,0,0,0,0,0,1,1,0,0,0,0
1,1,0,0,1,0,0,0,0,0,0,1,0,0,1,1
1,1,0,0,1,0,0,1,1,0,0,1,0,0,1,1
1,1,0,0,1,B,0,0,0,0,a,1,0,0,1,1