1,1,1,1,1,1,1,0,0,1,1,1,1,1,1,1
1,1,1,1,1,1,1,0,0,1,1,1,1,1,1,1
1,1,0,0,0,0,0,B,0,0,0,0,0,0,1,1
1,0,A,0,1,1,1,1,1,0,0,0,0,0,1,1
1,0,0,1,1,1,1,1,1,1,0,0,1,0,1,1
1,1,1,1,1,1,1,1,1,0,0,0,0,a,1,1


// 0- free space
// 1- wall
// A, B - robot's position
// a, b - goal
// Map with 2 robots