1,1,1,1,1,1,1,1,1,1,1,1,1,1,1,1
1,0,0,0,0,0,0,0,0,B,0,0,0,0,0,1
0,0,1,1,1,1,0,0,0,0,1,1,1,1,0,0
0,1,1,A,1,0,0,0,0,0,0,0,1,1,1,0
0,1,0,0,1,0,0,0,0,1,0,0,0,C,1,0
0,1,0,0,0,0,0,1,1,0,0,0,0,0,1,0
0,1,0,0,0,0,0,1,1,0,0,0,0,0,1,0
0,1,c,1,0,1,1,0,0,0,0,0,0,0,1,0
0,1,1,0,0,1,b,0,0,0,0,0,0,1,1,0
0,0,1,1,0,0,0,1,1,0,0,a,1,1,0,0
1,0,0,1,1,1,1,1,1,1,1,1,1,0,0,1
1,1,0,0,0,0,0,0,0,0,0,0,0,0,1,1


// 0- free space
// 1- wall
// a, b, c- robot's position
// A, B, C- goal
// Map with 3 robots